11111111111111111111111111111111
10000001000000000011000000000001
10000001000000000001000000000001
11111111000000000000000000000001
10000000000000000100000000001111
100000000C0000001011000000000001
100000000000000000P1000000001111
1100000E000000000011000000000001
100000000C0000000011000000000001
10000000000000000000000000000011
11111111111111111111111111111111